S   .   .   .   .   K1  #  
#   #   .   #   #   #   #  
K2  .   D1  .   .   .   .  
.   #   #   .   #   #   .  
.   .   .   .   .   D2  #  
.   #   #   #   #   .   #  
.   .   .   .   .   .   G  